,Rk,Team,G,MP,FG,FGA,FG%,3P,3PA,3P%,2P,2PA,2P%,FT,FTA,FT%,ORB,DRB,TRB,AST,STL,BLK,TOV,PF,PTS
0,1.0,Sacramento Kings*,82,20080,3132,6969,0.449,479,1353,0.354,2653,5616,0.472,1600,2075,0.771,987,2705,3692,1852,793,432,1221,1596,8343
1,2.0,Milwaukee Bucks*,82,19780,3112,6798,0.458,562,1481,0.379,2550,5317,0.48,1474,1874,0.787,975,2500,3475,1844,672,386,1123,1928,8260
2,3.0,Los Angeles Lakers*,82,19905,3109,6685,0.465,439,1275,0.344,2670,5410,0.494,1594,2333,0.683,1085,2583,3668,1888,564,490,1184,1872,8251
3,4.0,Dallas Mavericks*,82,19805,3085,6716,0.459,517,1357,0.381,2568,5359,0.479,1552,1954,0.794,831,2571,3402,1740,618,492,1141,1907,8239
4,5.0,Toronto Raptors*,82,19955,3048,6972,0.437,429,1164,0.369,2619,5808,0.451,1482,1984,0.747,1118,2529,3647,2004,599,519,1080,1745,8007
5,6.0,Orlando Magic*,82,19955,3013,6873,0.438,490,1346,0.364,2523,5527,0.456,1476,2068,0.714,1069,2450,3519,1803,674,481,1245,2071,7992
6,7.0,Minnesota Timberwolves*,82,19830,3148,6871,0.458,322,901,0.357,2826,5970,0.473,1364,1737,0.785,1002,2470,3472,2083,682,456,1136,1900,7982
7,8.0,Seattle SuperSonics,82,19805,3029,6649,0.456,466,1169,0.399,2563,5480,0.468,1454,1986,0.732,999,2422,3421,1792,657,409,1252,1733,7978
8,9.0,Houston Rockets,82,19830,2943,6494,0.453,504,1412,0.357,2439,5082,0.48,1582,2086,0.758,919,2524,3443,1613,587,358,1204,1657,7972
9,10.0,Utah Jazz*,82,19780,2960,6289,0.471,325,852,0.381,2635,5437,0.485,1714,2280,0.752,943,2383,3326,2110,661,463,1296,2107,7959
10,11.0,Denver Nuggets,82,19780,2979,6877,0.433,512,1444,0.355,2467,5433,0.454,1448,1964,0.737,1044,2583,3627,1970,552,538,1136,1820,7918
11,12.0,San Antonio Spurs*,82,19830,2884,6262,0.461,445,1094,0.407,2439,5168,0.472,1673,2340,0.715,902,2712,3614,1778,568,576,1145,1551,7886
12,13.0,Detroit Pistons,82,19855,2919,6880,0.424,389,1112,0.35,2530,5768,0.439,1610,2233,0.721,1108,2626,3734,1629,613,447,1304,1955,7837
13,14.0,Portland Trail Blazers*,82,19780,3004,6417,0.468,369,1057,0.349,2635,5360,0.492,1447,1899,0.762,960,2481,3441,1963,672,419,1257,1745,7824
14,15.0,Philadelphia 76ers*,82,19855,2902,6487,0.447,262,803,0.326,2640,5684,0.464,1697,2277,0.745,1075,2600,3675,1692,690,408,1292,1673,7763
15,16.0,Boston Celtics,82,19830,2773,6485,0.428,592,1633,0.363,2181,4852,0.45,1621,2190,0.74,897,2367,3264,1708,769,336,1285,1952,7759
16,17.0,Phoenix Suns*,82,19805,2944,6757,0.436,332,1054,0.315,2612,5703,0.458,1490,1973,0.755,970,2529,3499,1905,775,429,1250,1864,7710
17,18.0,Washington Wizards,82,19680,2833,6453,0.439,275,848,0.324,2558,5605,0.456,1704,2245,0.759,1016,2370,3386,1647,630,383,1391,1913,7645
18,19.0,Indiana Pacers*,82,19980,2828,6431,0.44,396,1159,0.342,2432,5272,0.461,1539,2009,0.766,921,2595,3516,1763,563,487,1244,1926,7591
19,20.0,Golden State Warriors,82,19780,2937,7175,0.409,282,964,0.293,2655,6211,0.427,1428,2024,0.706,1345,2385,3730,1788,742,410,1301,1727,7584
20,21.0,Los Angeles Clippers,82,20030,2896,6467,0.448,360,1063,0.339,2536,5404,0.469,1429,2061,0.693,962,2559,3521,1585,490,513,1293,1775,7581
21,22.0,Cleveland Cavaliers,82,19830,2890,6532,0.442,220,659,0.334,2670,5873,0.455,1561,2040,0.765,1015,2440,3455,1708,642,436,1350,1904,7561
22,23.0,New Jersey Nets,82,19730,2781,6550,0.425,361,1084,0.333,2420,5466,0.443,1629,2146,0.759,909,2337,3246,1603,649,407,1208,1982,7552
23,24.0,Charlotte Hornets*,82,19880,2800,6501,0.431,340,984,0.346,2460,5517,0.446,1599,2146,0.745,1033,2608,3641,1900,665,455,1183,1753,7539
24,25.0,Vancouver Grizzlies,82,19780,2870,6539,0.439,325,947,0.343,2545,5592,0.455,1457,1892,0.77,894,2431,3325,1899,586,359,1291,1733,7522
25,26.0,Atlanta Hawks,82,19730,2876,6668,0.431,333,933,0.357,2543,5735,0.443,1374,1811,0.759,1028,2490,3518,1559,634,387,1368,1863,7459
26,27.0,Miami Heat*,82,19880,2694,6258,0.43,478,1384,0.345,2216,4874,0.455,1423,1874,0.759,813,2435,3248,1630,633,304,1122,1726,7289
27,28.0,New York Knicks*,82,19905,2755,6198,0.444,391,1115,0.351,2364,5083,0.465,1374,1727,0.796,773,2524,3297,1520,545,346,1189,1863,7275
28,29.0,Chicago Bulls,82,19855,2721,6411,0.424,329,950,0.346,2392,5461,0.438,1410,1909,0.739,926,2260,3186,1810,675,379,1292,1902,7181
29,,League Average,82,19846,2926,6609,0.443,397,1124,0.354,2529,5485,0.461,1524,2039,0.748,983,2499,3482,1786,641,431,1234,1833,7774
